11111111111111111111111111111111
1.............1................1
1...222........................1
1...22.............E...........1
1.............1................1
1.............1................1
1...22........1........1.......1
1.............1........1..22...1
1.............1........1.......1
1...22........1........1..22...1
1.............1................1
1.............1................1
111111111111111.....111111111111
1..............................1
1......................111..1111
1......22..............1.......1
1......22..............1.......1
1......22..............1.......1
1......22..............1.......1
11111111111111......111111111111
1..............................1
1..............................1
1.P............................1
11111111111111111111111111111111
